                                                            
   #######################################################  
   #   #                                                 #  
   #   #   ###########################################   #  
   #   #   #                                         #   #  
   #   #   #   ###################################   #   #  
   #   #   #   #                                 #   #   #  
   #   #   #   #   ###########################   #   #   #  
   #   #   #   #   #                         #   #   #   #  
   #   #   #   #   #   ###################   #   #   #   #  
   #   #   #   #   #   #                 #   #   #   #   #  
   #   #   #   #   #   #   ###########   #   #   #   #   #  
   #   #   #   #   #   #   #         #   #   #   #   #   #  
   #   #   #   #   #   #   #   $##   #   #   #   #   #   #  
   #   #   #   #   #   #   #     #   #   #   #   #   #   #  
   #   #   #   #   #   #   #######   #   #   #   #   #   #  
   #   #   #   #   #   #             #   #   #   #   #   #  
   #   #   #   #   #   ###############   #   #   #   #   #  
   #   #   #   #   #                     #   #   #   #   #  
   #   #   #   #   #######################   #   #   #   #  
   #   #   #   #                             #   #   #   #  
   #   #   #######################################   #   #  
   #   #                                             #   #  
   #######################################################  
                                                            
